+-----------+
|FFFFTTTFFFF|
|FFFTTFFF TT|
|FFFTSTFFFFF|
|FFFF FFTTSF|
|SSFFFFTTFFF|
|FFFFFFTTFFF|
|FFFFFFFFFFF|
+-----------+