+-----------+
|FFFFTTTFFFF|
|FFFTTFFFFTT|
|FFFTSTFFFFF|
|FFFFFFFTTSF|
|SSFFFFTTFFF|
|FFFFFFTTFFF|
|FFFFFFFFFFF|
+-----------+